##......#...........
##......#..#.#.##...
..................#.
........#########...
................#..#
.....#.###..........
.....#...########.#.
.....#..............
.....#.......#.....#
.....#.......#......
.....######..#......
....................
#...................
######.......##.....
##......###..#......
##......#....#......
........#.#..#......
....................
....###..#####.##...
...#####............
